24
15
16
000000000000000000000000
1/1/1/0000000000001/1/1/
000000001/01/01/00000000
000000002/02/02/00000000
000000000000000000000000
0000001/1/00001/1/000000